Кассета "Агр 2"

ataka - Атака
ball - BALL
barmen - Бармен
bomber - Bomber Aircraft
chernyi - Черный ящик (запуск G ВК   RUN ВК)
draznil - Дразнилка (запуск G ВК   RUN ВК)
fondbirz - Фондовая биржа (запуск G ВК   RUN ВК)
gorynych - Змей Горыныч
kooperat - Кооператив (запуск G ВК   RUN ВК)
life - Жизнь
liquid - Liquid Sky
pentis - Пентис
pifpaf - ПифПаф
piton3 - Питон3
poker - Покер
redflow - Red Flower
sad - Сад
saper - Сапер
saper2 - Сапер2
skachki - Скачки
slams - Slams
snake - Snake
stakan - Стакан
torpeda - Торпедная атака
tsanshi - Цзяньшидзи (запуск G ВК   RUN ВК)
tsanshi3 - Цзяньшидзи3 (запуск G ВК   RUN ВК)

-------
Не прочитались :

Away
Spy's Demise
Штефан
Othello
